1 13 31
###############################
#p     s* *  1 *   b  *f* *   #
# # # #*# # #*#*# # # #*#*#*# #
#   *     ***  *      *   * * #
# # # # # #*# # #*#*# # # # #*#
#            **  *  *   2     #
# # # # # # # # # #*# #*# # # #
#*  *      *  *      **x      #
# # # # #*# # # #*#*# # # # # #
#*    **  *       *           #
# #*# # # # # # #*# # # # # # #
#           *   *  *          #
###############################