4 13 31
###############################
#p    1 * *    *   *  * f     #
# # # #*# # #*#*# # # #*#*#*# #
#         ***  *   1  *   * * #
# # # # # #*# # #*#*# # # # #*#
# *          **  *  *         #
# # # # # # # # # #*# #*# # # #
#*         *  *  2   *        #
# # # # #*# # # #*#*# # # # # #
#*    **  *   1   *           #
# #*# # # # # # #*# #b# # # # #
#    **     *   *x**   2      #
###############################