3 13 31
###############################
#p    *  s    *    1  *f      #
# # # # # # # # # #*# #*# # # #
#    *        **        1     #
# #b# # # #*# # #*# # # # # #*#
#  *        *         *       #
# # # # # # # # # #*# # # #*#*#
#     *  *        **        *b#
#*#*# # # # #*# # # # # # #*# #
#    *           *   2  *     #
# # # # # #*# # #*# # # #*# # #
#*  3   *        *        *   #
###############################