4 13 31
###############################
#p  x 1 * *    *   *  * *     #
# # # #*# # #*#*# # # #*#*#*# #
#  f      ***  *   1  *   * * #
# # # # # #*# # #*#*# # # # #*#
# *          **  *  *         #
# # # # # # # # # #*# #*# # # #
#*  f      *  *  2   *        #
# # # # #*# # # #*#*# # # # # #
#*    **  *   1   *           #
# #*# # # # # # #*# #b# # # # #
#    **     *   *  *   2      #
###############################