2 13 31
###############################
#p     b* *    *   *  * * *   #
# # # # # # #*#*# # # #*#*#*# #
#   *  *f * *  *   3  *   * * #
# #b# #x# #*# # #*#*# # # # #*#
#f   s       **  *  *         #
# # # # # # # # # #*# #*# # # #
#*  *   s  *  *      *        #
# # # # #*# # # #*#*# # # # # #
#*    **  *       *           #
# #*# # # # # # #*# # # # # # #
#           *   *  *          #
###############################