1 13 31
###############################
#p     s* *  1 *     *f * *   #
# # # #*# # #*#*# # # #*#*#*# #
#   *     ***  *  1   *   * * #
# # # # # #*# # #*#*# # # # #*#
#          x **  *  *   1     #
# # # # # # # # # #*# #*# # # #
#*  *      *  *      *        #
# # # # #*# # # #*#*# # # # # #
#*    **  *       *           #
# #*# # # # # # #*# # # # # # #
#        2  *   *  *          #
###############################