2 13 31
###############################
#p     b* *    *s  *  * *f*  x#
# # # # # # #*#*# # # #*#*#*# #
#   *  *  * *  *   1  *   * * #
# # # #*# #*# # #*#*# # # # #*#
#            **  *  *         #
# # # # # # # # # #*# #*# # # #
#*  *      *  *   1  *        #
# # # # #*# # # #*#*# # # # # #
#*    **  *       *2          #
# #*# # # # # # #*# # # # # # #
#           *   *  *          #
###############################