2 13 31
###############################
#p     b* *    *   *  * * *   #
# # # # # # #*#*# # # #*#*#*# #
#   *  *f * *  *   1  *   * * #
# #b# #x# #*# # #*#*# # # # #*#
#f   s       **  *  *         #
# # # # # # # # # #*# #*# # # #
#*  *   s  *  *   1  *        #
# # # # #*# # # #*#*# # # # # #
#*    **  *       *2          #
# #*# # # # # # #*# # # # # # #
#           *   *  *          #
###############################